S . . . X . . . . . . . X . .
. X . X . . . X . X . . . . .
X . . . . X . . . . . X . . .
. X . . . . . . X . . X . . .
. . X . . X . . . X . . . . X
X . . X . . . . X . . . . . .
. . X . . . . . X . . . X . .
. X . . . X . X . . X . . . .
. . . . X . . . . . X . . . .
X . . . X . . . X . . . X . .
. . X . . X . . . . . X . . .
. X . . . . X . . . . X . . .
X . X . X . . . . X . . X . .
. . . . X . . . X . . . . T .