S . . X . . . . X . . X . . .
. . X . . . X . . X . . . . .
X . . X . X . . . . . X . . .
. . . . . . . X . X . . . . .
X . . X . X . . . X . . . . .
. X . . . . X . . . X . . X .
. . . . X . . X . . X . . . .
. X . . . . . X . . . . X . .
. . X . . X . . . X . . . X .
X . . X . . . X T . . . X . .
. . X . . . X . X . . . . . .
. X . . X . . . . . X . . . .
X . . X . . X . . . . . . X .
. . X . . . X . . . X . . . .